13 9
40 40 40 40 40 40 40 40 40 40 40 40 40
40 01 02 02 02 03 40 01 02 02 02 03 40
40 04 11 12 13 02 02 02 22 23 24 05 40
40 04 14 15 16 12 12 12 15 15 26 05 40
40 04 14 15 16 18 18 18 15 15 26 05 40
40 04 14 15 16 10 07 09 25 15 26 05 40
40 04 17 18 19 05 40 04 27 28 29 05 40
40 06 07 07 07 08 40 06 07 07 07 08 40
40 40 40 40 40 40 40 40 40 40 40 40 40
