13 17
# tilemap
40 40 40 40 40 40 40 40 40 40 40 40 40
40 01 02 02 02 03 40 01 02 02 02 03 40
40 04 11 12 13 02 02 02 22 23 24 05 40
40 04 14 15 15 12 12 12 15 15 26 05 40
40 04 14 15 15 18 18 18 15 15 26 05 40
40 04 14 15 16 10 07 09 25 15 26 05 40
40 04 17 15 19 05 40 04 27 15 29 05 40
40 06 09 20 10 08 40 06 09 20 10 08 40
40 40 04 20 05 40 40 40 04 20 05 40 40
40 01 02 20 02 03 40 01 02 20 02 03 40
40 04 11 12 13 02 02 02 22 15 24 05 40
40 04 14 15 15 12 12 12 15 15 26 05 40
40 04 14 15 15 18 18 18 15 15 26 05 40
40 04 14 15 16 10 07 09 25 15 26 05 40
40 04 17 18 19 05 40 04 27 28 29 05 40
40 06 07 07 07 08 40 06 07 07 07 08 40
40 40 40 40 40 40 40 40 40 40 40 40 40
