40 40
40 40 40 40 40 40 40 40 40 40 40 40 40 40 40 40 40 40 40 40 40 40 40 40 40 40 40 40 40 40 40 40 40 40 40 40 40 40 40 40
40 01 02 02 02 02 02 02 03 40 40 40 40 40 40 40 40 40 40 40 40 40 01 02 02 02 02 02 02 02 02 02 02 02 02 02 02 02 03 40
40 04 15 12 12 12 12 15 02 02 02 02 02 02 02 02 02 02 02 02 02 02 02 12 12 12 12 12 12 12 12 12 12 12 12 12 12 12 03 40
40 04 15 15 15 15 15 15 12 12 12 12 12 12 12 12 12 12 12 12 12 12 12 15 15 15 15 15 15 15 15 15 15 15 15 15 15 15 03 40
40 04 15 15 15 15 15 15 15 15 15 15 15 15 15 15 15 15 15 15 15 15 15 15 15 15 15 15 15 15 10 07 07 09 15 15 15 15 03 40
40 04 15 15 15 15 15 15 10 07 07 07 07 07 07 07 07 07 07 07 09 15 15 15 15 15 15 15 15 15 02 02 02 02 15 15 15 15 03 40
40 04 15 15 15 15 15 15 05 40 40 40 40 40 40 40 40 40 40 40 04 15 15 15 15 15 15 15 15 15 15 15 15 15 15 15 15 15 03 40
40 06 07 07 09 15 15 10 08 40 40 40 40 40 40 40 40 40 40 40 04 15 10 09 15 15 15 15 15 15 15 15 15 15 15 15 15 15 03 40
40 40 40 40 04 15 15 05 40 40 40 40 40 40 40 40 40 40 40 40 06 07 08 06 07 07 07 07 07 07 09 15 15 15 15 10 07 07 08 40
40 40 40 40 04 15 15 05 40 40 40 40 40 40 40 40 40 40 40 40 40 40 40 40 40 40 40 40 40 40 04 38 15 15 36 05 40 40 40 40
40 40 01 02 02 15 15 02 03 40 40 40 40 40 40 40 40 40 40 40 40 40 01 02 02 02 02 02 02 02 02 25 15 15 26 02 02 02 03 40
40 40 04 15 12 15 15 12 02 03 40 40 40 40 40 40 40 40 40 40 40 40 04 22 23 23 23 23 23 23 23 39 15 15 37 23 23 24 03 40
40 40 04 15 15 15 15 15 12 02 03 40 40 40 40 40 40 40 40 40 40 40 04 25 36 28 28 28 28 28 28 38 15 15 15 15 15 26 03 40
40 40 06 07 07 09 15 15 15 12 02 03 40 40 40 40 40 40 40 40 40 40 04 25 26 10 07 07 07 07 09 25 15 15 15 15 15 26 03 40
40 40 40 40 40 06 09 15 15 15 12 02 02 02 02 02 02 02 03 40 40 40 04 25 26 05 40 40 40 40 04 25 15 15 15 15 15 26 03 40
40 40 40 40 40 40 01 15 15 15 15 12 12 12 12 12 12 12 02 05 40 40 04 39 37 05 40 40 40 40 04 25 15 15 15 15 15 26 03 40
40 40 40 40 40 40 01 15 15 15 15 15 15 15 15 15 15 15 12 05 40 40 04 15 15 05 40 40 40 40 04 25 15 15 15 15 15 26 03 40
40 40 40 40 40 01 02 15 15 15 10 07 07 07 07 07 09 15 15 02 02 02 02 15 15 05 40 40 40 40 04 25 36 28 28 28 38 26 03 40
40 40 40 40 01 02 15 15 15 10 40 40 40 40 40 40 04 15 15 12 12 12 12 15 15 05 40 40 40 40 04 25 26 10 07 09 25 26 03 40
40 40 01 02 02 15 15 15 10 08 40 40 40 40 40 40 06 09 15 15 15 15 15 15 15 05 40 40 40 40 04 25 26 05 40 04 25 26 03 40
40 40 04 15 15 15 15 10 08 40 40 40 40 40 40 40 40 06 07 07 07 07 07 07 07 08 40 40 40 40 04 25 26 05 40 04 25 26 03 40
40 40 04 15 15 15 10 08 40 40 40 40 40 40 40 40 40 40 40 40 40 40 40 40 40 40 40 40 40 40 04 25 26 05 40 04 25 26 03 40
40 40 04 15 15 15 05 40 40 40 40 40 40 40 40 40 40 40 40 40 40 40 40 40 40 40 40 40 40 40 04 25 26 02 02 02 25 26 03 40
40 40 04 15 15 15 05 01 02 02 02 02 02 02 02 02 02 02 02 02 02 02 02 02 02 02 02 02 02 02 02 25 37 23 23 23 39 26 03 40
40 40 04 15 15 10 08 04 15 15 21 21 21 21 21 21 21 21 21 21 21 21 21 21 21 21 21 21 21 21 21 27 28 28 28 38 36 29 03 40
40 40 04 15 15 05 40 04 15 15 10 07 07 07 07 07 07 07 07 07 07 07 07 07 07 07 07 07 07 07 07 07 07 07 09 25 26 10 08 40
40 01 02 15 15 02 05 04 15 15 05 40 40 40 40 40 40 40 40 40 40 40 40 40 40 40 40 40 40 40 40 40 40 40 04 25 26 05 40 40
40 04 15 15 15 15 05 04 15 15 05 40 40 40 40 40 40 40 40 40 40 40 01 02 02 03 40 40 40 40 40 40 40 40 04 39 37 05 40 40
40 04 15 15 15 15 05 04 15 15 05 40 40 40 40 40 40 40 40 40 40 40 04 15 15 05 40 40 40 40 40 40 40 40 04 15 15 05 40 40
40 06 09 15 15 10 08 04 15 15 05 40 40 40 40 40 40 40 01 02 02 02 02 15 15 03 40 40 40 40 40 40 40 40 04 15 15 05 40 40
40 40 04 15 15 05 40 04 15 15 05 40 40 40 40 40 40 40 04 15 15 15 15 15 15 05 40 40 40 40 40 40 40 40 04 15 15 05 40 40
40 40 04 15 15 02 05 04 15 15 05 40 40 40 40 40 40 40 04 15 15 15 15 15 15 05 40 40 40 40 40 40 40 40 04 15 15 05 40 40
40 40 04 15 15 15 05 04 15 15 05 40 40 40 40 40 40 40 06 09 15 15 10 07 07 08 40 40 40 40 40 40 40 40 04 15 15 05 40 40
40 40 04 15 15 15 05 04 15 15 05 40 40 40 40 40 40 40 40 04 15 15 05 40 40 40 40 40 40 40 40 40 40 40 04 15 15 05 40 40
40 40 04 15 15 15 05 04 15 15 05 40 40 40 40 40 40 40 40 04 15 15 05 40 40 40 40 40 40 40 40 40 40 40 04 15 15 05 40 40
40 01 02 15 15 15 02 02 15 15 02 02 02 02 02 02 02 02 02 02 15 15 02 02 02 02 02 02 02 02 02 02 02 02 02 15 15 02 03 40
40 04 15 15 15 15 15 15 15 15 15 15 15 15 15 15 15 15 15 15 15 15 15 15 15 15 15 15 15 15 15 15 15 15 15 15 15 15 05 40
40 04 15 15 15 15 15 15 15 15 15 15 15 15 15 15 15 15 15 15 15 15 15 15 15 15 15 15 15 15 15 15 15 15 15 15 15 15 05 40
40 06 07 07 07 07 07 07 07 07 07 07 07 07 07 07 07 07 07 07 07 07 07 07 07 07 07 07 07 07 07 07 07 07 07 07 07 07 08 40
40 40 40 40 40 40 40 40 40 40 40 40 40 40 40 40 40 40 40 40 40 40 40 40 40 40 40 40 40 40 40 40 40 40 40 40 40 40 40 40
